足球	Football
篮球	Basketball
黄色的	Yellow
橙色	Orange
1	1
2	2
3	3
4	4
5	5
门	Door
气球	Balloon
礼物	Gift
冰块	Ice
鸡蛋	Egg
米饭	Rice
盘子	Plate
帽子	Hat
手套	Gloves
床	Bed
起床	Get up
椅子	Chair
书桌	Desk
沙发	Sofa
电视	TV
桌子	Table
杯子	Cup
糖	Sugar
公共汽车站	Bus stop
公园	Park
出租车	Taxi
吉普车	Jeep
轮船	Ship
飞机	Airplane
茶	Tea
雨伞	Umbrella
手表	Watch
鸟	Bird
树	Tree
叶子	Leaves
花	Flower
蜜蜂	Bee
蚂蚁	Ant
风筝	Kite
