灯	lamp
小汽车	car
公共汽车	bus
自行车	bike
自行车	bicycle
球	ball
鱼	fish
树	tree
书	book
狗	dog
猫	cat
猴子	monkey
月亮	moon
猪	pig
糖	sugar
寒冷的	cold
炎热的	hot
大的	big
小的	small
老虎	tiger
脚	foot
水	water
马	horse
窗户	window
星星	star
大海 	see
鞋	shoe(S)
刀	knife
黑色的	black
白色的	white
红色的	red
蓝色的	blue
绿色的	green
